Level:6
Turn Count:10
Tile Count:42
Player Row Pos.:0
Player Col Pos.:0
===========================
1 1 1 1 1 1 1 1 1 1 
1 1 3 3 1 1 1 1 1 1 
1 3 3 3 3 11 11 11 1 1 
1 1 3 3 11 11 11 11 11 1 
1 1 1 1 1 1 1 1 1 1 
---------------------------
0 0 0 0 0 0 0 0 0 0 
0 0 0 0 0 0 0 0 0 0 
0 0 0 0 0 0 0 0 0 0 
0 0 0 0 0 0 0 0 0 0 
0 0 0 0 0 0 0 0 0 0 
%%%%%%%%%%%%%%%%%%%%%%%%%%%%
